wwwwwwwwwwwwwwwwwwwwwwwww
w...........c...........w
w..........ccc..........w
w........ccccccc........w
w......ccccccccccc......w
w...........c...........w
w...........c...........w
w...........c...........w
w...........c...........w
w...........c...........w
w...........c...........w
w.......................w
w.......................w
w.......................w
w.......................w
w.......................w
w.......................w
wwwwwwwwwwwwwwwwwwwwwwwww
